?
?
?                                                                                                                       |
?                                                                                                                       |
?                                                                                                                       |
?                                                                                                                       |
?                                           s                                                                           |
?  s                                      -----                                                                         |
?------                                  --   -                                                                         |
?                                       --    -                                                                     rrrr|
?                                      --     -                                                                     ----|
?                                     --      -                                                                         |
?                                    --       -                                                                         |
?                                   --        -                                                                         |
?                                  --         -                                                                         |
?----------------------------------------------------------------------------------------------------------------------------------------------